#S#######
#     # #
### # # #
# # #   #
# # ### #
#   #   #
##### ###
#       #
#######E#
