#S#############
#   #         #
# # # ####### #
# #   #     # #
# ##### ### # #
# #     #   # #
# # ##### #I# #
# #     # #   #
# ##### # #####
#     #   #   #
# ### # ##### #
#   # #      2#
##### ####### #
#    1#       #
#############E#
