#S###########
#     #     #
# ### # ### #
# # #   #   #
# #1##### ###
# #       # #
# # ####### #
# #   #     #
# ### # ### #
# #   #   # #
# #2##### # #
#I        # #
###########E#
