#S#############
#   #         #
# # # ##### ###
# #   #   #   #
#2## ## # ### #
# #     #     #
### #########1#
#   #     # # #
# ###I### # # #
#     #   #   #
####### # # ###
#       # # # #
# ####### # # #
# #           #
#############E#
